............
.........o..
..#.........
..#...######
..#.........
............
...#####....
...#........
...#...#####
...#........
......x.....
............