...#.........###
...#..###......#
...#...x####....
##......#.......
...######...####
...#....#......#
.###..######...#
........#..#.###
...#....#..#..##
####..#.#..##.##
......#....#...#
...######..#....
.#....#....###..
.#.####..#......
.#.......###...#
.#.......#o....#

................
................
................
......o.........
................
..........###...
..........#.....
.........##.....
.....#####......
....##..........
................
........x.......
................
................
................
................

